11111111111111111111111111111
1000000000000000000000000P001
10C010C0F0000000C000000000001
1E00000000C0000000F0000000001
11111111111111111111111111111