11111111111111111111111111111111111111
10000000100000000000000111000000C00011
100C00001000000000C0000010000000000001
1000000000000C000000000000000001000001
100000000000000000C0000000000000000E01
10000C00000000100000P000000C0000000001
11111111111111111111111111111111111111