11111111111111111111111111111111111111
10000000111111111111000111000000000011
10000000100000000000000010000000000E01
1000C000000000000000000000000001C00001
11111111100000000000000000000000000001
100P0000000000100000001110CCCCCCCC0001
11111111111111111111111111111111111111