11111111111111111111111111111111111111
10000000100000000000000111000000C00011
1000000C1000000000C0000010000000000E01
1000000P00000C000000000000000001000001
111111110000000000C0000000000000000001
10000C00000C001000CCC000000C0000000001
11111111111111111111111111111111111111