11111111111111111111111111111111111111
10000000111111111111000111011100000011
10000000100000000000000010010100000001
10000P00000000C000000E0000000101000001
11111111111100000000000000110000000001
100000CCCC0001100000001110010000000001
11111111111111111111111111111111111111